VeerleMertens2	cdenv	Federal Candidates CD&V Social Profiles
vincent_v_p	cdenv	Federal Candidates CD&V Social Profiles
ingemoors	cdenv	Federal Candidates CD&V Social Profiles
ServaisV	cdenv	Federal Candidates CD&V Social Profiles
PVanKemseke	cdenv	Federal Candidates CD&V Social Profiles
andy_vandevelde	cdenv	Federal Candidates CD&V Social Profiles
BiesemansD	cdenv	Federal Candidates CD&V Social Profiles
DeCupereAnnelie	cdenv	Federal Candidates CD&V Social Profiles
MarliesDeClercq	cdenv	Federal Candidates CD&V Social Profiles
Haeldermans	cdenv	Federal Candidates CD&V Social Profiles
Rafterwingen	cdenv	Federal Candidates CD&V Social Profiles
Stefaanvercamer	cdenv	Federal Candidates CD&V Social Profiles
KatrienVK	cdenv	Federal Candidates CD&V Social Profiles
ThomasVints	cdenv	Federal Candidates CD&V Social Profiles
Koen_Geens1	cdenv	Federal Candidates CD&V Social Profiles
F3lixDeClerck	cdenv	Federal Candidates CD&V Social Profiles
dalle_benjamin	cdenv	Federal Candidates CD&V Social Profiles
hendrikbogaert	cdenv	Federal Candidates CD&V Social Profiles
grietsmaers	cdenv	Federal Candidates CD&V Social Profiles
ThinkP	cdenv	Federal Candidates CD&V Social Profiles
Sarah_Claerhout	cdenv	Federal Candidates CD&V Social Profiles
MarleenStruyf	cdenv	Federal Candidates CD&V Social Profiles
DannyDEKOCK	cdenv	Federal Candidates CD&V Social Profiles
veliyuksel	cdenv	Federal Candidates CD&V Social Profiles
Burak_R_Dogan	cdenv	Federal Candidates CD&V Social Profiles
maaikebradt	cdenv	Federal Candidates CD&V Social Profiles
roeldeseyn	cdenv	Federal Candidates CD&V Social Profiles
NahimaLanjri	cdenv	Federal Candidates CD&V Social Profiles
stevenomblets	cdenv	Federal Candidates CD&V Social Profiles
Edwin_De_Cleyn	cdenv	Federal Candidates CD&V Social Profiles
WimBollaert	cdenv	Federal Candidates CD&V Social Profiles
NicAndriessen	cdenv	Federal Candidates CD&V Social Profiles
leendierick	cdenv	Federal Candidates CD&V Social Profiles
ElsVanHoofcdenv	cdenv	Federal Candidates CD&V Social Profiles
FrankyDemon	cdenv	Federal Candidates CD&V Social Profiles
laura_nevens	cdenv	Federal Candidates CD&V Social Profiles
SonjaBecq	cdenv	Federal Candidates CD&V Social Profiles
ChDepuydt	cdenv	Federal Candidates CD&V Social Profiles
GKindermans	cdenv	Federal Candidates CD&V Social Profiles
wbeke	cdenv	Federal Candidates CD&V Social Profiles
tomthijsen	cdenv	Federal Candidates CD&V Social Profiles
LiesbetSommen	cdenv	Federal Candidates CD&V Social Profiles
TVandormael	cdenv	Federal Candidates CD&V Social Profiles
g_schelstraete	cdenv	Federal Candidates CD&V Social Profiles
ThomasVOngeval	cdenv	Federal Candidates CD&V Social Profiles
KristofAudenaer	cdenv	Federal Candidates CD&V Social Profiles
DegheldereEvi	cdenv	Federal Candidates CD&V Social Profiles
MoniqueSwinnen	cdenv	Federal Candidates CD&V Social Profiles
patrickjanssen	cdenv	Federal Candidates CD&V Social Profiles
driescools	cdenv	Federal Candidates CD&V Social Profiles
pieterdecrem	cdenv	Federal Candidates CD&V Social Profiles
BiancaDebaets	cdenv	Federal Candidates CD&V Social Profiles
DeboeckL	cdenv	Federal Candidates CD&V Social Profiles
catherinefonck	cdh	Federal Candidates CDH Social Profiles
Cedricdumonceau	cdh	Federal Candidates CDH Social Profiles
MelchiorWath	cdh	Federal Candidates CDH Social Profiles
RomainMiraglia	ecolo	Federal Candidates Ecolo Social Profiles
JulieCrucke	ecolo	Federal Candidates Ecolo Social Profiles
samuelquievy	ecolo	Federal Candidates Ecolo Social Profiles
ZakiaKhattabi	ecolo	Federal Candidates Ecolo Social Profiles
OrianeTodts	ecolo	Federal Candidates Ecolo Social Profiles
Sarahturine	ecolo	Federal Candidates Ecolo Social Profiles
mattcontent	ecolo	Federal Candidates Ecolo Social Profiles
BenoitHellings	ecolo	Federal Candidates Ecolo Social Profiles
ParentNicolas	ecolo	Federal Candidates Ecolo Social Profiles
SiskaGaeremyn	ecolo	Federal Candidates Ecolo Social Profiles
rolandvsv	ecolo	Federal Candidates Ecolo Social Profiles
SophieAgapitos	ecolo	Federal Candidates Ecolo Social Profiles
BisetFrancis	ecolo	Federal Candidates Ecolo Social Profiles
LucParmentier	ecolo	Federal Candidates Ecolo Social Profiles
BeneHeindrichs	ecolo	Federal Candidates Ecolo Social Profiles
laureysv	ecolo	Federal Candidates Ecolo Social Profiles
GeorgesGilkinet	ecolo	Federal Candidates Ecolo Social Profiles
JulietteBoulet	ecolo	Federal Candidates Ecolo Social Profiles
AnnalisaGadalet	ecolo	Federal Candidates Ecolo Social Profiles
SarahSchlitz	ecolo	Federal Candidates Ecolo Social Profiles
DominiqueDecoux	ecolo	Federal Candidates Ecolo Social Profiles
Gilles_VDB	ecolo	Federal Candidates Ecolo Social Profiles
RDemeuse	ecolo	Federal Candidates Ecolo Social Profiles
LTemmerman	ecolo	Federal Candidates Ecolo Social Profiles
sophieboucquey	ecolo	Federal Candidates Ecolo Social Profiles
TaminesA	ecolo	Federal Candidates Ecolo Social Profiles
jmnollet	ecolo	Federal Candidates Ecolo Social Profiles
Antoine_Mariage	ecolo	Federal Candidates Ecolo Social Profiles
CThiemard	ecolo	Federal Candidates Ecolo Social Profiles
Hugues	fdf	Federal Candidates FDF Social Profiles
AmauryAlexandre	fdf	Federal Candidates FDF Social Profiles
Oussama27021985	groen	Federal Candidates Groen Social Profiles
TijsNaert	groen	Federal Candidates Groen Social Profiles
sienpillot	groen	Federal Candidates Groen Social Profiles
kconjaerts	groen	Federal Candidates Groen Social Profiles
HeidiVanheusden	groen	Federal Candidates Groen Social Profiles
WouterDeVriendt	groen	Federal Candidates Groen Social Profiles
DieterVanBesien	groen	Federal Candidates Groen Social Profiles
BramVB	groen	Federal Candidates Groen Social Profiles
omarfati	groen	Federal Candidates Groen Social Profiles
aardvdd	groen	Federal Candidates Groen Social Profiles
PBleyenberg	groen	Federal Candidates Groen Social Profiles
tomvandenborne	groen	Federal Candidates Groen Social Profiles
letisere	groen	Federal Candidates Groen Social Profiles
kristofcalvo	groen	Federal Candidates Groen Social Profiles
MaartenBrys	groen	Federal Candidates Groen Social Profiles
hoffelen	groen	Federal Candidates Groen Social Profiles
KatrienVanhove	groen	Federal Candidates Groen Social Profiles
Wim_VDW	groen	Federal Candidates Groen Social Profiles
markvrtervuren	groen	Federal Candidates Groen Social Profiles
filipwatteeuw	groen	Federal Candidates Groen Social Profiles
MiekeVogels	groen	Federal Candidates Groen Social Profiles
jeroendillen	groen	Federal Candidates Groen Social Profiles
SVHecke	groen	Federal Candidates Groen Social Profiles
MeyremAlmaci	groen	Federal Candidates Groen Social Profiles
mielcharles	groen	Federal Candidates Groen Social Profiles
ErikssonBritt	groen	Federal Candidates Groen Social Profiles
koenroman	groen	Federal Candidates Groen Social Profiles
DeJongeJasper	groen	Federal Candidates Groen Social Profiles
StafAerts	groen	Federal Candidates Groen Social Profiles
AntonDelbarre	groen	Federal Candidates Groen Social Profiles
KatrienEggers	groen	Federal Candidates Groen Social Profiles
JeremieVaneeckh	groen	Federal Candidates Groen Social Profiles
NieleGeypens	groen	Federal Candidates Groen Social Profiles
JoFobelets	groen	Federal Candidates Groen Social Profiles
DavidWemel	groen	Federal Candidates Groen Social Profiles
klaass_j	groen	Federal Candidates Groen Social Profiles
ProfDirkAvonts	groen	Federal Candidates Groen Social Profiles
LucRobijns	groen	Federal Candidates Groen Social Profiles
SybilleBauchau	mr	Federal Candidates MR Social Profiles
arde17	mr	Federal Candidates MR Social Profiles
SophieKeymolen1	mr	Federal Candidates MR Social Profiles
OChastel	mr	Federal Candidates MR Social Profiles
alexdupont1976	mr	Federal Candidates MR Social Profiles
gillesforet	mr	Federal Candidates MR Social Profiles
GautierCalomne	mr	Federal Candidates MR Social Profiles
AxelCriq	mr	Federal Candidates MR Social Profiles
ADolimont	mr	Federal Candidates MR Social Profiles
DBacquelaine	mr	Federal Candidates MR Social Profiles
DamienThiery	mr	Federal Candidates MR Social Profiles
BenoitFriart	mr	Federal Candidates MR Social Profiles
tellier_mr	mr	Federal Candidates MR Social Profiles
Ldefierlant	mr	Federal Candidates MR Social Profiles
DelphineMairy	mr	Federal Candidates MR Social Profiles
SabrinaBaraka	mr	Federal Candidates MR Social Profiles
JoBiermann	mr	Federal Candidates MR Social Profiles
Taqu1caro	mr	Federal Candidates MR Social Profiles
loranivesse	mr	Federal Candidates MR Social Profiles
dreynders	mr	Federal Candidates MR Social Profiles
PierreHUART	mr	Federal Candidates MR Social Profiles
SergeKubla	mr	Federal Candidates MR Social Profiles
anneferon	mr	Federal Candidates MR Social Profiles
Assita_Kanko	mr	Federal Candidates MR Social Profiles
DavidClarinval	mr	Federal Candidates MR Social Profiles
JessMayon	mr	Federal Candidates MR Social Profiles
ducarmedenis	mr	Federal Candidates MR Social Profiles
CharlesMichel75	mr	Federal Candidates MR Social Profiles
inez_deconinck	nva	Federal Candidates NVA Social Profiles
mireille1977	nva	Federal Candidates NVA Social Profiles
SarahSmeyers	nva	Federal Candidates NVA Social Profiles
peerlux	nva	Federal Candidates NVA Social Profiles
ElsVerbist	nva	Federal Candidates NVA Social Profiles
RaskinWouter	nva	Federal Candidates NVA Social Profiles
JanJambon	nva	Federal Candidates NVA Social Profiles
Bart_DeWever	nva	Federal Candidates NVA Social Profiles
sthbracke	nva	Federal Candidates NVA Social Profiles
svandeput	nva	Federal Candidates NVA Social Profiles
allessiaclaes	nva	Federal Candidates NVA Social Profiles
VermeulenBrecht	nva	Federal Candidates NVA Social Profiles
OlivierGodfroid	nva	Federal Candidates NVA Social Profiles
CarlGeeraerts	nva	Federal Candidates NVA Social Profiles
philiproosen	nva	Federal Candidates NVA Social Profiles
YoleenVanCamp	nva	Federal Candidates NVA Social Profiles
WernerJanssen00	nva	Federal Candidates NVA Social Profiles
LucDemullier	nva	Federal Candidates NVA Social Profiles
jdewolfs	nva	Federal Candidates NVA Social Profiles
ThanneeSchaalje	nva	Federal Candidates NVA Social Profiles
BVanhorenbeek	nva	Federal Candidates NVA Social Profiles
DillenKoen	nva	Federal Candidates NVA Social Profiles
CMolderez	nva	Federal Candidates NVA Social Profiles
FriedaGijbels	nva	Federal Candidates NVA Social Profiles
TindemansE	nva	Federal Candidates NVA Social Profiles
BertWollants	nva	Federal Candidates NVA Social Profiles
Jnachtergaele	nva	Federal Candidates NVA Social Profiles
kris10vanvaer	nva	Federal Candidates NVA Social Profiles
jan_laceur	nva	Federal Candidates NVA Social Profiles
ClausJcl	nva	Federal Candidates NVA Social Profiles
peterdedecker	nva	Federal Candidates NVA Social Profiles
FPerdaens	nva	Federal Candidates NVA Social Profiles
JanDeHaes	nva	Federal Candidates NVA Social Profiles
veerlebaeyens	nva	Federal Candidates NVA Social Profiles
PeterDeRoover1	nva	Federal Candidates NVA Social Profiles
Sander_R_	nva	Federal Candidates NVA Social Profiles
Veerle_Wouters	nva	Federal Candidates NVA Social Profiles
RenateHufkens	nva	Federal Candidates NVA Social Profiles
WeversW	nva	Federal Candidates NVA Social Profiles
robvandevelde	nva	Federal Candidates NVA Social Profiles
valerievanpeel	nva	Federal Candidates NVA Social Profiles
JohanGuldix	nva	Federal Candidates NVA Social Profiles
JoostArents	nva	Federal Candidates NVA Social Profiles
DeWitSophie	nva	Federal Candidates NVA Social Profiles
stijnq	nva	Federal Candidates NVA Social Profiles
marcroppe	nva	Federal Candidates NVA Social Profiles
FVannetelbosch	nva	Federal Candidates NVA Social Profiles
lahimpe	nva	Federal Candidates NVA Social Profiles
FranckenTheo	nva	Federal Candidates NVA Social Profiles
VincentVQ	openvld	Federal Candidates Open VLD Social Profiles
fontaintje	openvld	Federal Candidates Open VLD Social Profiles
tryckalts	openvld	Federal Candidates Open VLD Social Profiles
Vloemans_Ce	openvld	Federal Candidates Open VLD Social Profiles
Elke_Malotiaux	openvld	Federal Candidates Open VLD Social Profiles
TimVandenput	openvld	Federal Candidates Open VLD Social Profiles
CarinaVanCauter	openvld	Federal Candidates Open VLD Social Profiles
FannyDecock	openvld	Federal Candidates Open VLD Social Profiles
avivotchka	openvld	Federal Candidates Open VLD Social Profiles
alexandradarch	openvld	Federal Candidates Open VLD Social Profiles
AndyDeCock	openvld	Federal Candidates Open VLD Social Profiles
kgysels	openvld	Federal Candidates Open VLD Social Profiles
WardVergote	openvld	Federal Candidates Open VLD Social Profiles
ATurtelboom	openvld	Federal Candidates Open VLD Social Profiles
IneSomers	openvld	Federal Candidates Open VLD Social Profiles
PieterDebou	openvld	Federal Candidates Open VLD Social Profiles
MarianeVerhaert	openvld	Federal Candidates Open VLD Social Profiles
MargotNeyskens	openvld	Federal Candidates Open VLD Social Profiles
GertVdEeken	openvld	Federal Candidates Open VLD Social Profiles
sarahtaybi	openvld	Federal Candidates Open VLD Social Profiles
SophieNicque	openvld	Federal Candidates Open VLD Social Profiles
LdeLuk	openvld	Federal Candidates Open VLD Social Profiles
grietmebis	openvld	Federal Candidates Open VLD Social Profiles
Nelelijnen	openvld	Federal Candidates Open VLD Social Profiles
sandrinedecrom	openvld	Federal Candidates Open VLD Social Profiles
PatrickDewael	openvld	Federal Candidates Open VLD Social Profiles
taylor_kenneth	openvld	Federal Candidates Open VLD Social Profiles
JasperPillen	openvld	Federal Candidates Open VLD Social Profiles
MarcVanAperen	openvld	Federal Candidates Open VLD Social Profiles
stephaniedhose	openvld	Federal Candidates Open VLD Social Profiles
alexanderdecroo	openvld	Federal Candidates Open VLD Social Profiles
LievenCobbaert	openvld	Federal Candidates Open VLD Social Profiles
dirksterckx	openvld	Federal Candidates Open VLD Social Profiles
LukVanBiesen	openvld	Federal Candidates Open VLD Social Profiles
pietdelrue	openvld	Federal Candidates Open VLD Social Profiles
SaraCasteur	openvld	Federal Candidates Open VLD Social Profiles
AnnMichiels	openvld	Federal Candidates Open VLD Social Profiles
vereeck	openvld	Federal Candidates Open VLD Social Profiles
StijnPluym	openvld	Federal Candidates Open VLD Social Profiles
VeroniqueCaerts	openvld	Federal Candidates Open VLD Social Profiles
LNauwelaerts	openvld	Federal Candidates Open VLD Social Profiles
egbertlachaert	openvld	Federal Candidates Open VLD Social Profiles
TobyFischler	openvld	Federal Candidates Open VLD Social Profiles
AnciauxKoen	openvld	Federal Candidates Open VLD Social Profiles
markdelion	openvld	Federal Candidates Open VLD Social Profiles
ElsieSierens	openvld	Federal Candidates Open VLD Social Profiles
AnthonyDumarey	openvld	Federal Candidates Open VLD Social Profiles
FemkeVerleye	openvld	Federal Candidates Open VLD Social Profiles
WimDeWaele	openvld	Federal Candidates Open VLD Social Profiles
SabineLeyzen	openvld	Federal Candidates Open VLD Social Profiles
JosMombaers	openvld	Federal Candidates Open VLD Social Profiles
MohamedAhouna	openvld	Federal Candidates Open VLD Social Profiles
Krisjelena	openvld	Federal Candidates Open VLD Social Profiles
KarinHeremans	openvld	Federal Candidates Open VLD Social Profiles
plvandijck	openvld	Federal Candidates Open VLD Social Profiles
DirkVanMechele1	openvld	Federal Candidates Open VLD Social Profiles
emir_kir	ps	Federal Candidates PS Social Profiles
JulieFFernandez	ps	Federal Candidates PS Social Profiles
CourardPhilippe	ps	Federal Candidates PS Social Profiles
OzlemOzen1	ps	Federal Candidates PS Social Profiles
Olihen	ps	Federal Candidates PS Social Profiles
danielsenesael	ps	Federal Candidates PS Social Profiles
annicksaudoyer	ps	Federal Candidates PS Social Profiles
Gwengrovonius	ps	Federal Candidates PS Social Profiles
karinelalieux	ps	Federal Candidates PS Social Profiles
FredericDaerden	ps	Federal Candidates PS Social Profiles
FabienneWinckel	ps	Federal Candidates PS Social Profiles
eliodirupo	ps	Federal Candidates PS Social Profiles
gilsimonBe	ps	Federal Candidates PS Social Profiles
JacquesGobert	ps	Federal Candidates PS Social Profiles
andreflahaut	ps	Federal Candidates PS Social Profiles
ThWarmoes	ptb	Federal Candidates PTB Social Profiles
Marco_VanHees	ptb	Federal Candidates PTB Social Profiles
RaoulHedebouw	ptb	Federal Candidates PTB Social Profiles
BenjPestieau	ptb	Federal Candidates PTB Social Profiles
lizafrica13	ptb	Federal Candidates PTB Social Profiles
SanderVDCapelle	pvda	Federal Candidates PVDA Social Profiles
DirkTuypens	pvda	Federal Candidates PVDA Social Profiles
DirkVanDuppen	pvda	Federal Candidates PVDA Social Profiles
DeWitteKim	pvda	Federal Candidates PVDA Social Profiles
TomDMeester	pvda	Federal Candidates PVDA Social Profiles
SofieSas	pvda	Federal Candidates PVDA Social Profiles
SDereymaeker	pvda	Federal Candidates PVDA Social Profiles
pollever	pvda	Federal Candidates PVDA Social Profiles
peter_mertens	pvda	Federal Candidates PVDA Social Profiles
BenjPestieau	pvda	Federal Candidates PVDA Social Profiles
MeryameKitir	spa	Federal Candidates SP.a Social Profiles
LouisTobback	spa	Federal Candidates SP.a Social Profiles
lorevonck	spa	Federal Candidates SP.a Social Profiles
pehlivan_fatma	spa	Federal Candidates SP.a Social Profiles
Karline_Libert	spa	Federal Candidates SP.a Social Profiles
KaurPritty	spa	Federal Candidates SP.a Social Profiles
MeulemanBrent	spa	Federal Candidates SP.a Social Profiles
karintemmerman	spa	Federal Candidates SP.a Social Profiles
PolStaut	spa	Federal Candidates SP.a Social Profiles
MaiteMorren	spa	Federal Candidates SP.a Social Profiles
VvelthovenPeter	spa	Federal Candidates SP.a Social Profiles
FrankVanDessel	spa	Federal Candidates SP.a Social Profiles
RudyCoddens	spa	Federal Candidates SP.a Social Profiles
BaukeVdg	spa	Federal Candidates SP.a Social Profiles
AlainYzermans	spa	Federal Candidates SP.a Social Profiles
birgittcarlier	spa	Federal Candidates SP.a Social Profiles
buraknalli	spa	Federal Candidates SP.a Social Profiles
stephcamu	spa	Federal Candidates SP.a Social Profiles
Nonunsenses	spa	Federal Candidates SP.a Social Profiles
MohamedRidouani	spa	Federal Candidates SP.a Social Profiles
Houari1800	spa	Federal Candidates SP.a Social Profiles
HannesAnaf	spa	Federal Candidates SP.a Social Profiles
jbl9100	spa	Federal Candidates SP.a Social Profiles
Ellen_akw	spa	Federal Candidates SP.a Social Profiles
FreijaD	spa	Federal Candidates SP.a Social Profiles
IngaVerhaert	spa	Federal Candidates SP.a Social Profiles
AllemaalSam	spa	Federal Candidates SP.a Social Profiles
HichamElMzairh	spa	Federal Candidates SP.a Social Profiles
AnjaVanrobaeys	spa	Federal Candidates SP.a Social Profiles
WendyRoegiest	spa	Federal Candidates SP.a Social Profiles
MonicaDeConinck	spa	Federal Candidates SP.a Social Profiles
SvenTaeldeman	spa	Federal Candidates SP.a Social Profiles
DeBoeckTom	spa	Federal Candidates SP.a Social Profiles
Fauzaya	spa	Federal Candidates SP.a Social Profiles
DeirdreGouwy	spa	Federal Candidates SP.a Social Profiles
alain_top	spa	Federal Candidates SP.a Social Profiles
Y_Semlali	spa	Federal Candidates SP.a Social Profiles
TamaraSchotte	spa	Federal Candidates SP.a Social Profiles
LesiaRadelicki	spa	Federal Candidates SP.a Social Profiles
LambrechtAnnick	spa	Federal Candidates SP.a Social Profiles
GertHerman	spa	Federal Candidates SP.a Social Profiles
JeanPierreDeGro	spa	Federal Candidates SP.a Social Profiles
PaulBeloy	spa	Federal Candidates SP.a Social Profiles
GeertsDavid	spa	Federal Candidates SP.a Social Profiles
elkevespen	spa	Federal Candidates SP.a Social Profiles
jvlberghe	spa	Federal Candidates SP.a Social Profiles
FDW_VB	vlaamsbelang	Federal Candidates Vlaams Belang Social Profiles
bertschoofs	vlaamsbelang	Federal Candidates Vlaams Belang Social Profiles
Philip_Claeys	vlaamsbelang	Federal Candidates Vlaams Belang Social Profiles
Barbara_Pas	vlaamsbelang	Federal Candidates Vlaams Belang Social Profiles
BUB_BELG	bub	B.U.B Social Profiles
cdenv	cdenv	CD&V Social Profiles
lecdh	cdh	CDH Social Profiles
DeboutLesBelges	debout_les_belges	Debout Les Belges Social Profiles
Ecolo	ecolo	Ecolo Social Profiles
les_fdf	fdf	FDF Social Profiles
groen	groen	Groen Social Profiles
MR_officiel	mr	MR Social Profiles
de_NVA	nva	N-VA Social Profiles
openvld	openvld	Open VLD Social Profiles
piratesbelgium	pirateparty	Pirate Party Social Profiles
PSofficiel	ps	PS Social Profiles
ptbbelgique	ptb	PTB Social Profiles
pvdabelgie	pvda	PVDA Social Profiles
sp_a	spa	Sp.a Social Profiles
vlbelang	vlaamsbelang	Vlaams Belang Social Profiles
